000XXXXXXXXXXXXXXXXXXXXXXXXXXXXXXXXXXXXXXX
000X00000000000X00000000000000X00000X00X00
X00XXXX00XXXX00X00X00XXXXXXX00X00XXXX00X00
X00X00000000X00X00X00X00000X00000000000000
X00XXXXXXX00XXXXXXX00XXXX00XXXXXXXXXX00X00
X00000000000000X00X00000000X00X00000X00X00
XXXX00X00X00XXXX00XXXX00XXXX00X00XXXX00XXX
X00000X00X00X00000X00X00000X00000X00000X00
XXXX00XXXX00XXXX00X00XXXX00XXXX00XXXXXXX00
X00000X00X00000000X00000000000X00000X00000
X00XXXX00XXXX00XXXXXXX00X00XXXXXXX00X00X00
X00000X00000X00000X00X00X00000000X00X00X00
X00XXXXXXX00XXXXXXX00X00XXXX00X00X00XXXX00
X00000000X00X00000X00000000X00X00000X00000
XXXX00XXXX00X00XXXX00XXXX00XXXX00XXXXXXX00
X00000000000000X00000X00000X00X00000000X00
XXXXXXX00XXXXXXXXXXXXXXXX00X00X00XXXX00X00
X00000X00000000000000000000000X00X00000000
XXXX00X00XXXX00XXXX00X00X00X00XXXX00XXXX00
X00X00X00X00000000X00X00X00X00000X00X00000
X00X00XXXXXXXXXX00X00XXXXXXX00XXXXXXX00XXX
X00000X00000X00000X00000000X00X00000000000
X00X00X00X00X00X00XXXX00XXXXXXXXXXXXXXXX00
X00X00X00X00000X00000X00000000000000X00000
X00XXXXXXX00XXXXXXX00XXXXXXX00X00XXXXXXXXX
X00000000X00000X00000X00000000X00000X00X00
XXXX00XXXXXXXXXX00XXXXXXXXXXXXXXXX00X00X00
X00X00000000000000X00000000000X00X00000X00
X00X00X00XXXXXXXXXXXXXXXX00X00X00X00XXXX00
X00000X00X00X00000X00000X00X00X00000000000
X00XXXXXXX00XXXX00X00XXXX00XXXXXXXXXXXXX00
X00000000X00000X00000000X00000000X00000X00
X00X00X00X00XXXX00X00XXXXXXX00XXXX00X00XXX
X00X00X00000000000X00X00000000000X00X00000
X00XXXX00X00XXXXXXXXXX00XXXXXXX00XXXXXXX00
X00X00X00X00000X00000000000000X00000000000
XXXX00XXXX00X00X00XXXXXXXXXXXXX00X00XXXX00
X00000000X00X00X00000000000X00000X00X00X00
XXXX00X00XXXX00XXXXXXXXXX00XXXX00X00X00XXX
X00000X00000000X00000X00X00X00000X00X00X00
X00XXXX00X00X00XXXX00X00X00XXXXXXX00X00X00
X00000X00X00X00000000000000000X00000000000
XXXXXXXXXXXXXXXXXXXXXXXXXXXXXXXXXXXXXXXX00
