0000XXXXXXXXXXXXXXXXXXXXXXXXXXXXXXXXXXXXXX
000000000000X00000000000X00000X00000000X00
X000XXX00X00XXXXXXX00XXXXXXX00XXXX00X00X00
X00000000X00X00000X00000000000000000X00000
X00X00XXXXXXX00XXXX00XXXXXXXXXX00XXXX00X00
X00X00X00000000000000X00X00X00X00X00X00X00
X00X00X00X00X00XXXX00X00X00X00X00X00X00X00
X00000000X00X00X00X00000X00000X00000X00X00
XXXXXXXXXX00X00X00X00XXXXXXX00XXXXXXX00X00
X00000X00000X00000X00000X00X00000000X00X00
X00XXXX00XXXXXXXXXX00X00X00XXXX00XXXXXXXXX
X00000X00X00000000X00X00X00000000000000000
X00X00XXXX00XXXXXXX00X00X00X00XXXX00XXXX00
X00X00000000X00X00X00X00000X00000X00X00000
X00X00X00X00X00X00XXXXXXX00X00X00XXXXXXX00
X00X00X00X00000X00000X00X00X00X00X00000X00
XXXX00X00X00XXXX00X00X00X00XXXXXXXXXX00X00
X00000X00X00X00000X00000000X00000000X00000
XXXXXXX00XXXXXXX00XXXXXXXXXX00X00XXXXXXX00
X00X00000000000X00000000000X00X00000X00000
X00X00X00XXXXXXXXXX00XXXX00XXXX00XXXX00XXX
X00000X00000X00X00000X00X00X00000000X00000
X00XXXX00XXXX00X00XXXX00X00XXXX00X00XXXX00
X00X00X00X00000000000000X00X00000X00X00000
XXXX00X00X00XXXXXXX00X00XXXXXXX00XXXXXXXXX
X00000000X00X00000000X00000X00000000000000
X00XXXXXXXXXXXXXXXX00XXXX00XXXXXXX00X00X00
X00X00000000X00000000X00000000000000X00X00
X00X00XXXXXXXXXX00XXXX00X00X00X00XXXXXXX00
X00000000000000000000X00X00X00X00000X00000
X00XXXX00XXXX00XXXXXXX00XXXXXXX00XXXX00X00
X00X00000X00000000000X00000X00000X00X00X00
X00XXXXXXXXXXXXXXXXXXX00X00XXXX00X00X00XXX
X00X00000000X00000X00000X00X00000X00000000
X00X00XXXX00X00X00XXXXXXX00X00X00XXXX00XXX
X00000X00000X00X00X00000X00X00X00000X00000
X00XXXXXXXXXX00X00XXXX00XXXXXXX00XXXX00XXX
X00X00X00000X00X00X00X00X00000X00X00000000
X00X00XXXX00XXXX00X00X00XXXX00XXXXXXXXXX00
X00000X00000X00000X00000000X00X00X00000000
XXXX00XXXX00XXXX00XXXXXXX00X00X00X00XXXX00
X00000000000000000000000000000X00000X00000
XXXXXXXXXXXXXXXXXXXXXXXXXXXXXXXXXXXXXXXX00
