000000XXXXXXXXXXXXXXXXXXXXXXXXXXXXXXXXXXXX
000000000000000000X00000000000X00000000000
XXXX00XXXXXXX00XXXXXXXXXX00X00XXXXXXX00X00
X00000000X00X00000X00000X00X00X00000X00X00
X000XXXXXX00XXXX00X00XXXX00X00X00XXXXXXX00
X00000000000000X00000000000X00000000X00000
X000XXXXXXXXX00X00X00XXXXXXX00XXXX00XXXX00
X00000X00000X00000X00X00000X00X00000000000
X00XXXX00XXXXXXX00X00X00XXXXXXXXXXXXX00X00
X00X00000X00X00000X00X00000000000000000X00
XXXXXXX00X00X00XXXXXXXXXXXXXXXXXXXXXXXXXXX
X00000000X00000000X00X00000X00000000X00X00
XXXX00XXXX00XXXXXXX00XXXX00X00X00X00X00X00
X00000000000000000000000000000X00X00000000
X00XXXXXXXXXX00XXXXXXX00XXXXXXX00XXXX00X00
X00X00000X00000000X00000X00000000X00000X00
XXXXXXX00XXXXXXX00XXXX00XXXXXXX00XXXX00XXX
X00000000X00000000X00000X00X00000X00000X00
X00XXXX00X00XXXXXXXXXX00X00XXXXXXX00XXXX00
X00X00000X00X00X00000000000X00000X00000X00
X00XXXX00X00X00XXXXXXXXXXXXXXXX00XXXXXXX00
X00000X00000000000X00000000X00000X00X00000
X00X00XXXXXXXXXX00X00X00XXXX00XXXX00X00X00
X00X00X00X00000X00000X00000X00X00X00X00X00
X00XXXX00X00X00XXXX00XXXX00X00X00X00X00XXX
X00000000X00X00000000000X00000000000000000
X00XXXXXXX00XXXXXXXXXX00X00XXXX00XXXXXXX00
X00000X00000000X00X00000X00X00000000000X00
X00XXXXXXXXXX00X00X00XXXXXXXXXXXXXXXXXXX00
X00X00000X00000X00X00X00000000000000X00000
XXXX00XXXXXXXXXX00XXXX00XXXXXXXXXX00X00XXX
X00000X00000000000X00X00X00X00000000X00000
X00XXXX00X00XXXXXXX00XXXX00X00XXXXXXX00XXX
X00000000X00X00000X00X00X00000X00000X00000
X00XXXX00X00X00XXXX00X00X00X00X00XXXXXXX00
X00X00000X00X00000000X00000X00000000000000
XXXX00XXXX00XXXXXXX00XXXXXXXXXXXXXXXX00XXX
X00X00X00000000X00X00000X00000000000000X00
X00X00XXXX00XXXX00X00X00X00X00XXXXXXX00X00
X00X00000X00X00000000X00000X00000X00000000
X00XXXXXXX00XXXXXXXXXXXXX00X00X00XXXX00XXX
X00000000000000000000000000X00X00000X00000
XXXXXXXXXXXXXXXXXXXXXXXXXXXXXXXXXXXXXXXX00
