000XXXXXXXXXXXXXXXXXXXXXXXXXXXXXXXXXXXXXXX
000X00000X00000X00000000X00000000000X00000
X00X00XXXX00X00XXXXXXX00X00X00X00XXXXXXX00
X00X00X00000X00X00X00000000X00X00000000000
X00X00XXXX00XXXX00X00XXXX00XXXXXXXXXXXXXXX
X00000000000X00000000X00X00X00000000X00000
X00X00XXXXXXXXXXXXXXXX00X00XXXXXXX00X00XXX
X00X00X00000000000000000000000X00000000000
X00X00XXXXXXX00X00X00X00XXXX00XXXX00XXXXXX
X00X00000000000X00X00X00X00X00X00000X00000
X00XXXXXXXXXX00X00XXXX00X00X00XXXX00X00X00
X00X00000000000X00000X00X00000000000X00X00
XXXXXXX00XXXXXXXXXX00XXXXXXXXXX00XXXX00XXX
X00000000X00X00X00X00000000X00X00000X00000
X00XXXXXXX00X00X00X00XXXXXXX00XXXX00X00X00
X00000X00000X00000000000000X00000X00000X00
X00X00X00X00XXXXXXXXXX00X00X00X00XXXX00X00
X00X00000X00000X00000X00X00X00X00000000X00
X00XXXXXXX00XXXX00XXXXXXX00X00XXXXXXXXXX00
X00X00000X00000000X00X00X00X00000X00000000
X00XXXX00XXXXXXX00X00X00X00XXXXXXX00X00X00
X00X00000X00X00X00X00000000000000X00X00X00
XXXXXXX00X00X00XXXXXXXXXX00XXXX00XXXXXXX00
X00000X00000000X00X00000X00X00X00000X00000
XXXX00X00XXXXXXX00XXXX00X00X00X00XXXXXXX00
X00000X00000000000000000X00000X00000000X00
XXXX00X00X00X00X00XXXX00XXXX00X00XXXXXXXXX
X00X00X00X00X00X00X00000000X00X00000000000
X00X00X00X00XXXX00XXXX00X00X00X00XXXXXXX00
X00000X00X00X00000000X00X00000X00000X00X00
XXXX00XXXX00XXXXXXXXXXXXXXXXXXXXXXXXX00X00
X00X00000X00X00000000000000000000X00000000
X00X00XXXXXXXXXXXXXXXXXXXXXX00XXXXXXX00X00
X00000X00000000X00000000X00X00X00000000X00
X00XXXX00X00X00X00XXXXXXX00X00XXXXXXX00X00
X00000000X00X00X00000000000000X00000X00X00
XXXX00X00X00X00X00XXXXXXX00XXXXXXX00XXXX00
X00000X00X00X00000X00000X00000000000X00X00
X00XXXXXXXXXXXXXXXXXXX00X00X00XXXX00X00X00
X00000X00000X00000000X00X00X00X00000000000
X00XXXXXXX00X00X00X00X00XXXX00X00X00XXXX00
X00X00000000000X00X00000000000X00X00000X00
XXXXXXXXXXXXXXXXXXXXXXXXXXXXXXXXXXXXXXXX00
