000XXXXXXXXXXXXXXXXXXXXXXXXXXXXXXXXXXXXXXX
000X00000X00X00000000000000X00000000000000
X00XXXX00X00XXXXXXXXXX00XXXXXXX00X00XXXXXX
X00X00000X00000X00X00000000X00000X00000000
X00XXXX00X00X00X00XXXX00X00XXXX00X00XXXXXX
X00000X00000X00000000000X00X00000X00000000
XXXX00XXXX00XXXXXXXXXX00XXXX00XXXXXXXXXX00
X00X00000000X00000X00X00X00000000000X00000
X00X00X00XXXXXXX00X00XXXXXXX00X00XXXXXXX00
X00000X00X00000X00000000X00000X00X00X00000
XXXX00XXXX00X00XXXX00X00X00XXXXXXX00XXXXXX
X00000X00X00X00X00X00X00000X00000X00X00000
X00XXXX00X00XXXX00XXXX00XXXX00X00X00X00XXX
X00X00000X00000000000000X00000X00X00000000
X00X00XXXXXXX00X00X00XXXX00XXXXXXXXXXXXX00
X00000000X00000X00X00000X00000000000000000
X00XXXX00X00X00XXXX00XXXX00XXXXXXXXXXXXXXX
X00000X00000X00X00000000X00000000000X00000
XXXX00X00XXXX00XXXX00XXXX00X00XXXXXXXXXX00
X00000X00000X00000X00000000X00X00000X00X00
X00X00X00XXXX00X00X00XXXX00XXXX00X00X00X00
X00X00X00X00000X00X00X00X00X00000X00000000
XXXXXXXXXX00XXXXXXX00X00X00XXXX00X00XXXXXX
X00X00000000X00X00000X00000X00000X00000000
X00XXXXXXXXXX00X00XXXXXXXXXXXXXXXXXXX00XXX
X00000000X00000000000X00000X00000000000X00
X00XXXXXXXXXXXXX00X00X00XXXXXXXXXX00XXXX00
X00000X00X00X00000X00000000X00X00000000000
X00XXXX00X00XXXXXXXXXX00X00X00XXXXXXX00XXX
X00000000000000000X00X00X00000000X00000000
XXXX00X00X00X00XXXX00XXXXXXXXXX00XXXX00XXX
X00000X00X00X00X00000X00X00X00000000000000
X00X00XXXX00X00X00X00X00X00X00X00XXXX00XXX
X00X00X00X00X00000X00000000000X00000X00X00
X00XXXX00X00XXXX00XXXXXXX00XXXXXXX00X00X00
X00X00000000X00000X00000000000000X00X00000
XXXXXXX00XXXXXXXXXX00XXXXXXXXXXXXX00XXXXXX
X00000000000X00000000000000X00000X00000000
X00XXXX00XXXXXXXXXX00XXXXXXX00X00X00XXXXXX
X00X00000X00000000X00000000000X00X00000X00
X00X00XXXXXXXXXX00X00X00XXXX00XXXXXXX00X00
X00X00000X00000000000X00X00000X00000000000
XXXXXXXXXXXXXXXXXXXXXXXXXXXXXXXXXXXXXXXX00
