000XXXXXXXXXXXXXXXXXXXXXXXXXXXXXXXXXXXXXXX
000000000X00X00X00X00X00000000X00X00000000
X00XXXXXXX00X00X00X00X00X00XXXX00X00X00XXX
X00000000000000X00000000X00000000X00X00000
X00XXXXXXX00XXXX00X00XXXXXXXXXXXXXXXX00X00
X00X00X00000000000X00X00000X00000X00000X00
XXXX00XXXXXXXXXXXXX00X00X00X00XXXXXXXXXX00
X00000X00X00000X00000000X00X00000000X00000
XXXX00X00XXXX00X00X00X00XXXX00X00X00X00X00
X00000X00000X00000X00X00X00X00X00X00X00X00
XXXX00XXXX00X00XXXXXXX00X00X00XXXX00X00X00
X00000000000000X00X00000000X00000X00000X00
X00XXXX00XXXXXXX00X00X00X00XXXX00XXXXXXXXX
X00X00000000000X00X00X00X00X00000000X00000
XXXX00X00XXXXXXX00XXXX00X00X00X00XXXX00X00
X00X00X00000X00000000000X00000X00000000X00
X00XXXXXXX00X00XXXXXXXXXXXXXXXX00X00XXXX00
X00X00X00X00X00X00000X00X00X00000X00X00000
X00X00X00XXXXXXX00XXXX00X00X00X00XXXX00XXX
X00000000X00X00000000000000000X00X00X00X00
X00XXXXXXX00XXXXXXXXXX00X00X00X00X00XXXX00
X00000000000X00X00000X00X00X00X00X00X00000
X00XXXXXXX00X00X00X00X00XXXX00XXXX00X00XXX
X00X00000000X00000X00X00X00X00000X00000000
X00X00XXXXXXX00X00XXXXXXX00X00XXXXXXXXXX00
X00X00X00X00000X00000X00X00000000X00000000
X00XXXX00XXXX00X00X00X00X00X00X00XXXX00X00
X00X00000X00X00X00X00X00000X00X00000000X00
X00X00XXXX00X00X00XXXX00XXXXXXX00XXXXXXX00
X00000000X00X00X00X00000000X00X00X00000000
X00XXXXXXX00X00X00X00XXXXXXX00X00XXXXXXXXX
X00X00000X00000X00X00000000X00000000X00000
X00XXXX00X00X00XXXX00XXXXXXXXXX00XXXX00XXX
X00000000000X00X00000X00X00X00000000X00000
X00X00X00X00XXXXXXX00X00X00X00X00XXXXXXX00
X00X00X00X00000X00000X00X00000X00000000000
XXXXXXXXXX00XXXXXXX00X00X00X00XXXXXXX00XXX
X00000X00000000000X00X00000X00X00000X00X00
XXXX00XXXXXXX00XXXX00XXXX00X00X00XXXXXXX00
X00X00000000X00X00X00X00X00X00000X00000000
X00XXXXXXX00X00X00X00X00XXXXXXX00X00X00XXX
X00000000000000000000000000000X00000X00000
XXXXXXXXXXXXXXXXXXXXXXXXXXXXXXXXXXXXXXXX00
